@@@&&&&&&&&@@@@@&&&&&&&&&&########
%@&&&@@@&&&&&&&@&&&&&&&#&#&######&
%%@&&&@&&&&&@@@&&&&&&#&#&#&#&&&##&
%%%@&&@&&&@@@@&&&&&&&##&##&##&###&
%%%%@&@&&@@&&&&&##&&###&##&##&##&&
%%%%%@@@@@&&&##&##&###&&&&&##&#&&#
@%%%%%@@@#&&&&#&&&&#&&&&#&&&&&#&&&
@@@@%%%%%%&&#&&&##&&&##&&#&&#&&&#@