#############
###&@@@&&@@%#
%%%&@@&&&@@%%
#%&&&@@@&&@%@
#%%%&&&&&@%%%
###%%%%%%%%#%
#####%%%%###%