###@@###%
##@@&&&#%
@#####&#%
@@@@###%%
#@%%%%%%%